RESULTS UNEQUAL: PlotWindowAttribute_galaxy0030_all_ParticleProjectionPlot_particle_mass_x_pan_(((0_1, 0_1),), {})_	test_particle_projection_answers[x-pan]
RESULTS UNEQUAL: PlotWindowAttribute_galaxy0030_all_ParticleProjectionPlot_particle_mass_x_pan_rel_(((0_1, 0_1),), {})_	test_particle_projection_answers[x-pan_rel]
RESULTS UNEQUAL: PlotWindowAttribute_galaxy0030_all_ParticleProjectionPlot_particle_mass_x_set_axes_unit_(('kpc',), {})_	test_particle_projection_answers[x-axis_unit_kpc]
RESULTS UNEQUAL: PlotWindowAttribute_galaxy0030_all_ParticleProjectionPlot_particle_mass_x_set_axes_unit_(('Mpc',), {})_	test_particle_projection_answers[x-axis_unit_mpc]
RESULTS UNEQUAL: PlotWindowAttribute_galaxy0030_all_ParticleProjectionPlot_particle_mass_x_set_axes_unit_((('kpc', 'kpc'),), {})_	test_particle_projection_answers[x-axis_unit_kpc_kpc]
RESULTS UNEQUAL: PlotWindowAttribute_galaxy0030_all_ParticleProjectionPlot_particle_mass_x_set_axes_unit_((('kpc', 'Mpc'),), {})_	test_particle_projection_answers[x-axis_unit_kpc_mpc]
RESULTS UNEQUAL: PlotWindowAttribute_galaxy0030_all_ParticleProjectionPlot_particle_mass_x_set_buff_size_((1600,), {})_	test_particle_projection_answers[x-buff_size_1600]
RESULTS UNEQUAL: PlotWindowAttribute_galaxy0030_all_ParticleProjectionPlot_particle_mass_x_set_buff_size_(((600, 800),), {})_	test_particle_projection_answers[x-buff_size_600_800]
RESULTS UNEQUAL: PlotWindowAttribute_galaxy0030_all_ParticleProjectionPlot_particle_mass_x_set_center_(((0_4, 0_3),), {})_	test_particle_projection_answers[x-center]
RESULTS UNEQUAL: PlotWindowAttribute_galaxy0030_all_ParticleProjectionPlot_particle_mass_x_set_cmap_(('particle_mass', 'RdBu'), {})_	test_particle_projection_answers[x-cmap_RdBu]
RESULTS UNEQUAL: PlotWindowAttribute_galaxy0030_all_ParticleProjectionPlot_particle_mass_x_set_cmap_(('particle_mass', 'kamae'), {})_	test_particle_projection_answers[x-cmap_kamae]
RESULTS UNEQUAL: PlotWindowAttribute_galaxy0030_all_ParticleProjectionPlot_particle_mass_x_set_font_((OrderedDict([('family', 'sans-serif'), ('size', 24), ('style', 'italic'), ('weight', 'bold')]),), {})_	test_particle_projection_answers[x-font]
RESULTS UNEQUAL: PlotWindowAttribute_galaxy0030_all_ParticleProjectionPlot_particle_mass_x_set_log_(('particle_mass', False), {})_	test_particle_projection_answers[x-log]
PYTEST KEYERROR: PlotWindowAttribute_galaxy0030_all_ParticleProjectionPlot_particle_mass_x_set_window_size_((7_0,), {})_	test_particle_phase_answers[ylim]
RESULTS UNEQUAL: PlotWindowAttribute_galaxy0030_all_ParticleProjectionPlot_particle_mass_x_set_window_size_((7_0,), {})_	test_particle_phase_answers[ylim]
PYTEST KEYERROR: PlotWindowAttribute_galaxy0030_all_ParticleProjectionPlot_particle_mass_x_set_zlim_(('particle_mass', 1e+39, 1e+42), {})_	test_particle_phase_answers[ylim]
RESULTS UNEQUAL: PlotWindowAttribute_galaxy0030_all_ParticleProjectionPlot_particle_mass_x_set_zlim_(('particle_mass', 1e+39, 1e+42), {})_	test_particle_phase_answers[ylim]
PYTEST KEYERROR: PlotWindowAttribute_galaxy0030_all_ParticleProjectionPlot_particle_mass_x_set_zlim_(('particle_mass', 1e+39, None), {'dynamic_range': 4})_	test_particle_phase_answers[ylim]
RESULTS UNEQUAL: PlotWindowAttribute_galaxy0030_all_ParticleProjectionPlot_particle_mass_x_set_zlim_(('particle_mass', 1e+39, None), {'dynamic_range': 4})_	test_particle_phase_answers[ylim]
RESULTS UNEQUAL: PlotWindowAttribute_galaxy0030_all_ParticleProjectionPlot_particle_mass_x_zoom_((10,), {})_	test_particle_projection_answers[x-zoom]
RESULTS UNEQUAL: PlotWindowAttribute_galaxy0030_all_ParticleProjectionPlot_particle_mass_x_toggle_right_handed_((), {})_	test_particle_projection_answers[x-toggle_rh]
RESULTS UNEQUAL: PlotWindowAttribute_galaxy0030_all_ParticleProjectionPlot_particle_mass_y_pan_(((0_1, 0_1),), {})_	test_particle_projection_answers[y-pan]
RESULTS UNEQUAL: PlotWindowAttribute_galaxy0030_all_ParticleProjectionPlot_particle_mass_y_pan_rel_(((0_1, 0_1),), {})_	test_particle_projection_answers[y-pan_rel]
RESULTS UNEQUAL: PlotWindowAttribute_galaxy0030_all_ParticleProjectionPlot_particle_mass_y_set_axes_unit_(('kpc',), {})_	test_particle_projection_answers[y-axis_unit_kpc]
RESULTS UNEQUAL: PlotWindowAttribute_galaxy0030_all_ParticleProjectionPlot_particle_mass_y_set_axes_unit_(('Mpc',), {})_	test_particle_projection_answers[y-axis_unit_mpc]
RESULTS UNEQUAL: PlotWindowAttribute_galaxy0030_all_ParticleProjectionPlot_particle_mass_y_set_axes_unit_((('kpc', 'kpc'),), {})_	test_particle_projection_answers[y-axis_unit_kpc_kpc]
RESULTS UNEQUAL: PlotWindowAttribute_galaxy0030_all_ParticleProjectionPlot_particle_mass_y_set_axes_unit_((('kpc', 'Mpc'),), {})_	test_particle_projection_answers[y-axis_unit_kpc_mpc]
RESULTS UNEQUAL: PlotWindowAttribute_galaxy0030_all_ParticleProjectionPlot_particle_mass_y_set_buff_size_((1600,), {})_	test_particle_projection_answers[y-buff_size_1600]
RESULTS UNEQUAL: PlotWindowAttribute_galaxy0030_all_ParticleProjectionPlot_particle_mass_y_set_buff_size_(((600, 800),), {})_	test_particle_projection_answers[y-buff_size_600_800]
RESULTS UNEQUAL: PlotWindowAttribute_galaxy0030_all_ParticleProjectionPlot_particle_mass_y_set_center_(((0_4, 0_3),), {})_	test_particle_projection_answers[y-center]
RESULTS UNEQUAL: PlotWindowAttribute_galaxy0030_all_ParticleProjectionPlot_particle_mass_y_set_cmap_(('particle_mass', 'RdBu'), {})_	test_particle_projection_answers[y-cmap_RdBu]
RESULTS UNEQUAL: PlotWindowAttribute_galaxy0030_all_ParticleProjectionPlot_particle_mass_y_set_cmap_(('particle_mass', 'kamae'), {})_	test_particle_projection_answers[y-cmap_kamae]
RESULTS UNEQUAL: PlotWindowAttribute_galaxy0030_all_ParticleProjectionPlot_particle_mass_y_set_font_((OrderedDict([('family', 'sans-serif'), ('size', 24), ('style', 'italic'), ('weight', 'bold')]),), {})_	test_particle_projection_answers[y-font]
RESULTS UNEQUAL: PlotWindowAttribute_galaxy0030_all_ParticleProjectionPlot_particle_mass_y_set_log_(('particle_mass', False), {})_	test_particle_projection_answers[y-log]
PYTEST KEYERROR: PlotWindowAttribute_galaxy0030_all_ParticleProjectionPlot_particle_mass_y_set_window_size_((7_0,), {})_	test_particle_phase_answers[ylim]
RESULTS UNEQUAL: PlotWindowAttribute_galaxy0030_all_ParticleProjectionPlot_particle_mass_y_set_window_size_((7_0,), {})_	test_particle_phase_answers[ylim]
PYTEST KEYERROR: PlotWindowAttribute_galaxy0030_all_ParticleProjectionPlot_particle_mass_y_set_zlim_(('particle_mass', 1e+39, 1e+42), {})_	test_particle_phase_answers[ylim]
RESULTS UNEQUAL: PlotWindowAttribute_galaxy0030_all_ParticleProjectionPlot_particle_mass_y_set_zlim_(('particle_mass', 1e+39, 1e+42), {})_	test_particle_phase_answers[ylim]
PYTEST KEYERROR: PlotWindowAttribute_galaxy0030_all_ParticleProjectionPlot_particle_mass_y_set_zlim_(('particle_mass', 1e+39, None), {'dynamic_range': 4})_	test_particle_phase_answers[ylim]
RESULTS UNEQUAL: PlotWindowAttribute_galaxy0030_all_ParticleProjectionPlot_particle_mass_y_set_zlim_(('particle_mass', 1e+39, None), {'dynamic_range': 4})_	test_particle_phase_answers[ylim]
RESULTS UNEQUAL: PlotWindowAttribute_galaxy0030_all_ParticleProjectionPlot_particle_mass_y_zoom_((10,), {})_	test_particle_projection_answers[y-zoom]
RESULTS UNEQUAL: PlotWindowAttribute_galaxy0030_all_ParticleProjectionPlot_particle_mass_y_toggle_right_handed_((), {})_	test_particle_projection_answers[y-toggle_rh]
RESULTS UNEQUAL: PlotWindowAttribute_galaxy0030_all_ParticleProjectionPlot_particle_mass_z_pan_(((0_1, 0_1),), {})_	test_particle_projection_answers[z-pan]
RESULTS UNEQUAL: PlotWindowAttribute_galaxy0030_all_ParticleProjectionPlot_particle_mass_z_pan_rel_(((0_1, 0_1),), {})_	test_particle_projection_answers[z-pan_rel]
RESULTS UNEQUAL: PlotWindowAttribute_galaxy0030_all_ParticleProjectionPlot_particle_mass_z_set_axes_unit_(('kpc',), {})_	test_particle_projection_answers[z-axis_unit_kpc]
RESULTS UNEQUAL: PlotWindowAttribute_galaxy0030_all_ParticleProjectionPlot_particle_mass_z_set_axes_unit_(('Mpc',), {})_	test_particle_projection_answers[z-axis_unit_mpc]
RESULTS UNEQUAL: PlotWindowAttribute_galaxy0030_all_ParticleProjectionPlot_particle_mass_z_set_axes_unit_((('kpc', 'kpc'),), {})_	test_particle_projection_answers[z-axis_unit_kpc_kpc]
RESULTS UNEQUAL: PlotWindowAttribute_galaxy0030_all_ParticleProjectionPlot_particle_mass_z_set_axes_unit_((('kpc', 'Mpc'),), {})_	test_particle_projection_answers[z-axis_unit_kpc_mpc]
RESULTS UNEQUAL: PlotWindowAttribute_galaxy0030_all_ParticleProjectionPlot_particle_mass_z_set_buff_size_((1600,), {})_	test_particle_projection_answers[z-buff_size_1600]
RESULTS UNEQUAL: PlotWindowAttribute_galaxy0030_all_ParticleProjectionPlot_particle_mass_z_set_buff_size_(((600, 800),), {})_	test_particle_projection_answers[z-buff_size_600_800]
RESULTS UNEQUAL: PlotWindowAttribute_galaxy0030_all_ParticleProjectionPlot_particle_mass_z_set_center_(((0_4, 0_3),), {})_	test_particle_projection_answers[z-center]
RESULTS UNEQUAL: PlotWindowAttribute_galaxy0030_all_ParticleProjectionPlot_particle_mass_z_set_cmap_(('particle_mass', 'RdBu'), {})_	test_particle_projection_answers[z-cmap_RdBu]
RESULTS UNEQUAL: PlotWindowAttribute_galaxy0030_all_ParticleProjectionPlot_particle_mass_z_set_cmap_(('particle_mass', 'kamae'), {})_	test_particle_projection_answers[z-cmap_kamae]
RESULTS UNEQUAL: PlotWindowAttribute_galaxy0030_all_ParticleProjectionPlot_particle_mass_z_set_font_((OrderedDict([('family', 'sans-serif'), ('size', 24), ('style', 'italic'), ('weight', 'bold')]),), {})_	test_particle_projection_answers[z-font]
RESULTS UNEQUAL: PlotWindowAttribute_galaxy0030_all_ParticleProjectionPlot_particle_mass_z_set_log_(('particle_mass', False), {})_	test_particle_projection_answers[z-log]
PYTEST KEYERROR: PlotWindowAttribute_galaxy0030_all_ParticleProjectionPlot_particle_mass_z_set_window_size_((7_0,), {})_	test_particle_phase_answers[ylim]
RESULTS UNEQUAL: PlotWindowAttribute_galaxy0030_all_ParticleProjectionPlot_particle_mass_z_set_window_size_((7_0,), {})_	test_particle_phase_answers[ylim]
PYTEST KEYERROR: PlotWindowAttribute_galaxy0030_all_ParticleProjectionPlot_particle_mass_z_set_zlim_(('particle_mass', 1e+39, 1e+42), {})_	test_particle_phase_answers[ylim]
RESULTS UNEQUAL: PlotWindowAttribute_galaxy0030_all_ParticleProjectionPlot_particle_mass_z_set_zlim_(('particle_mass', 1e+39, 1e+42), {})_	test_particle_phase_answers[ylim]
PYTEST KEYERROR: PlotWindowAttribute_galaxy0030_all_ParticleProjectionPlot_particle_mass_z_set_zlim_(('particle_mass', 1e+39, None), {'dynamic_range': 4})_	test_particle_phase_answers[ylim]
RESULTS UNEQUAL: PlotWindowAttribute_galaxy0030_all_ParticleProjectionPlot_particle_mass_z_set_zlim_(('particle_mass', 1e+39, None), {'dynamic_range': 4})_	test_particle_phase_answers[ylim]
RESULTS UNEQUAL: PlotWindowAttribute_galaxy0030_all_ParticleProjectionPlot_particle_mass_z_zoom_((10,), {})_	test_particle_projection_answers[z-zoom]
RESULTS UNEQUAL: PlotWindowAttribute_galaxy0030_all_ParticleProjectionPlot_particle_mass_z_toggle_right_handed_((), {})_	test_particle_projection_answers[z-toggle_rh]
PYTEST KEYERROR: PlotWindowAttribute_galaxy0030_all_ParticleProjectionPlot_('formed_star', 'particle_mass')_x_set_log_(('particle_mass', False), {})_	test_particle_phase_answers[ylim]
RESULTS UNEQUAL: PlotWindowAttribute_galaxy0030_all_ParticleProjectionPlot_('formed_star', 'particle_mass')_x_set_log_(('particle_mass', False), {})_	test_particle_phase_answers[ylim]
PYTEST KEYERROR: PlotWindowAttribute_galaxy0030_all_ParticleProjectionPlot_('formed_star', 'particle_mass')_y_set_log_(('particle_mass', False), {})_	test_particle_phase_answers[ylim]
RESULTS UNEQUAL: PlotWindowAttribute_galaxy0030_all_ParticleProjectionPlot_('formed_star', 'particle_mass')_y_set_log_(('particle_mass', False), {})_	test_particle_phase_answers[ylim]
PYTEST KEYERROR: PlotWindowAttribute_galaxy0030_all_ParticleProjectionPlot_('formed_star', 'particle_mass')_z_set_log_(('particle_mass', False), {})_	test_particle_phase_answers[ylim]
RESULTS UNEQUAL: PlotWindowAttribute_galaxy0030_all_ParticleProjectionPlot_('formed_star', 'particle_mass')_z_set_log_(('particle_mass', False), {})_	test_particle_phase_answers[ylim]
RESULTS UNEQUAL: PhasePlotAttribute_galaxy0030_all_ParticlePhasePlot_particle_velocity_x_particle_velocity_y_particle_mass_annotate_text_(((5e-29, 50000000_0), 'Hello YT'), {})	test_particle_phase_answers[ylim]
RESULTS UNEQUAL: PhasePlotAttribute_galaxy0030_all_ParticlePhasePlot_particle_velocity_x_particle_velocity_y_particle_mass_annotate_text_(((5e-29, 50000000_0), 'Hello YT'), {'color': 'b'})	test_particle_phase_answers[ylim]
RESULTS UNEQUAL: PhasePlotAttribute_galaxy0030_all_ParticlePhasePlot_particle_velocity_x_particle_velocity_y_particle_mass_set_title_(('particle_mass', 'A phase plot_'), {})	test_particle_phase_answers[ylim]
RESULTS UNEQUAL: PhasePlotAttribute_galaxy0030_all_ParticlePhasePlot_particle_velocity_x_particle_velocity_y_particle_mass_set_log_(('particle_mass', False), {})	test_particle_phase_answers[ylim]
RESULTS UNEQUAL: PhasePlotAttribute_galaxy0030_all_ParticlePhasePlot_particle_velocity_x_particle_velocity_y_particle_mass_set_unit_(('particle_mass', 'Msun'), {})	test_particle_phase_answers[ylim]
RESULTS UNEQUAL: PhasePlotAttribute_galaxy0030_all_ParticlePhasePlot_particle_velocity_x_particle_velocity_y_particle_mass_set_xlim_((-40000000_0, 40000000_0), {})	test_particle_phase_answers[ylim]
RESULTS UNEQUAL: PhasePlotAttribute_galaxy0030_all_ParticlePhasePlot_particle_velocity_x_particle_velocity_y_particle_mass_set_ylim_((-40000000_0, 40000000_0), {})	test_particle_phase_answers[ylim]
